Albedo - Albert
Alhaitham - Ali
Aloy - 
Amber - Bori
Ayaka - Ángyika
Ayato - Ajtony
Itto - István
Barbara - Barbara
Beidou - Bernadett
Bennett - Béni
Candace - Kasszandra
Chongyun - Csongi
Childe - Csanád
Collei - Kolli
Cyno - Sanyó
Dainsleif - Dénes
Diluc - Dani
Diona - Dia
Dori - Dóri 
Eula - Laura
Faruzan - Fruzsi
Fischl - Flóra
Ganyu - Gyöngyi
Gorou - Gergő
Heizhou - Hetény
Hu Tao - Tea
Jean - Janka
Kazuha - Kázmér
Kaeya - Károly
Kokomi - Korina
Kuki - Süti
Keqing - Kinga
Klee - Klári
Layla - Lejla
Lisa - Liza
Mona - Móni
Nahida - Nati 
Ningguang - Niki
Nilou - Níla
Noelle - Noella
Qiqi - Gizi
Raiden - Évi
Razor - Radiátor
Rosaria - Rozi
Kokomi - Korinna
Sara - Sára
Sayu - Szandi
Shenhe - Szende
Shinobu - Szimóna
Sucrose - Cukor
Thoma - Tomi
Tighnari - Tihamér
Traveler - Utazó
Venti - Barni
Xiao - Samu
Xingqiu - Szindbád
Xinyan - Szintia
Xiangling - Csingiling
Yanfei - Jana
Yae Miko - Molli
Yelan - Jolán
Yoimiya - Joli
Yun Jin - Juli
Scara - Salamon
Zhongli - Zoli